1111111111111100000001111111111
1000000000000100000001000000001
1000000000000100000001000000001
1000000000000111111111000000001
1000002220000000000000000000001
1000002120000111111111000000010
1000000000000100000000111011100
1000000000001100000000000000000
1000001010010100000000000000000
1111011111111100000000000000000
